4444444444444444444444444444444
4444444444444444444444444444444
4111111111111111111111111111114
4100000000000000000000000000014
4100000000000000000000000000014
4100000000000000000000000000014
41000P0000000000111111000000014
4100000000000000111111000000014
4100011000000000111111000000014
4100000000000000111111000000014
4100000000011100000000000000014
4100000000011100000000000000014
4100000000011100000000A00000014
4100000000000000000000000000014
4100000000000000000000000000014
4100000000000000000000000000014
4100000000000000000000000000014
4100000000000000000000000000014
4100000000000000000000000000014
4111111111111111111111111111114
4444444444444444444444444444444
4444444444444444444444444444444

