1144444444444444444444444444444444444444444
4444444444444444444444444444444444444444444
4444444444444444444444444444444444444444444
4444111111111111111111111111114444444444444
4444110000000000000000000000114444444444444
444411000P000000000000000000114444444444444
4444110000000000000000500000114444444444444
4444110000000000000000000000114444444444444
4444110000000000000000000000114444444444444
4444110000000000001111110000114444444444444
4444110001100000000000000000114444444444444
4444110000000000000000000000114444444444444
4444110005000000111110000000114444444444444
4444110000000000000000000000114444444444444
4444110000000000000000000000114444444444444
4444110000100000000000110000114444444444444
4444110000100000000000000000114444444444444
4444110000100000000000000000114444444444444
4444110000100000000000000000114444444444444
4444110000000000000000000000114444444444444
4444110000000000000000000000114444444444444
4444111111111111111111111111114444444444444
4444444444444444444444444444444444444444444
4444444444444444444444444444444444444444444
4444444444444444444444444444444444444444444
4444444444444444444444444444444444444444444
4444444444444444444444444444444444444444444
4444444444444444444444444444444444444444444
4444444444444444444444444444444444444444444
4444444444444444444444444444444444444444444
4444444444444444444444444444444444444444444
4444444444444444444444444444444444444444444
4444444444444444444444444444444444444444444
