444444444444444444444444444444444444444444444444444444444444444444444444444
444444444444444444444444444444444444444444444444444444444444444444444444444
444444444444444444444444444444444444444444444444444444444444444444444444444
444444444444444444444444444444444444444444444444444444444444444444444444444
444444444444444444444444444444444444444444444444444444444444444444444444444
444444444444444444444444444444444444444444444444444444444444444444444444444
444411111111111111111111111111444444444444444444444444444444444444444444444
444444444444444444444444444444444444444444444444444444444444444444444444444
444444444444444444444444444444444444444444444444444444444444444444444444444
444411000000000000000000000011444444444444400000000000000000114444444444444
44441100000P000000000000000000000000000000000000000000000000114444444444444
444411000000000000010000000000000000000000000011111000000000114444444444444
444444444444444444444444444444444444444444444444444000000000444444444444444
444444444444444444444444444444444444444444444444444000000000444444444444444
444444444444444444444444444444444444444444444444444000000000444444444444444
444444444444444444444444444444444444444444444444444000000000444444444444444
444444444444444444444444444444444444444444444444444000000000444444444444444
444444444444444444444444444444444440000004444444444000000000444444444444444
444444444444444444444444444444444444400000004444444000000000444444444444444
444444444444444444444444444444444444444000000444444000000000444444444444444
444444444444444444444444444444444444444444000000000000000000444444444444444
444444444444444444444444444444444444444444444444444000000000444444444444444
444444444444444444444444444444444444444444444444444444444444444444444444444
444444444444444444444444444444444444444444444444444444444444444444444444444
444444444444444444444444444444444444444444444444444444444444444444444444444
444444444444444444444444444444444444444444444444444444444444444444444444444
444444444444444444444444444444444444444444444444444444444444444444444444444
444444444444444444444444444444444444444444444444444444444444444444444444444
444444444444444444444444444444444444444444444444444444444444444444444444444
444444444444444444444444444444444444444444444444444444444444444444444444444
444444444444444444444444444444444444444444444444444444444444444444444444444
444444444444444444444444444444444444444444444444444444444444444444444444444
444444444444444444444444444444444444444444444444444444444444444444444444444
444444444444444444444444444444444444444444444444444444444444444444444444444
444444444444444444444444444444444444444444444444444444444444444444444444444
444444444444444444444444444444444444444444444444444444444444444444444444444
444444444444444444444444444444444444444444444444444444444444444444444444444
444444444444444444444444444444444444444444444444444444444444444444444444444