444444444444444444444444444444444444444444444444444444444444444444444444444
444444444444444444444444444444444444444444444444444444444444444444444444444
444444444444444444444444444444444444444444444444444444444444444444444444444
444444444444444444444444444444444444444444444444444444444444444444444444444
444444444444444444444444444444444444444444444444444444444444444444444444444
444444444444444444444444444444444444444444444444444444444444444444444444444
444411111111111111111111111111444444444444444444444444444444444444444444444
444444444444444444444444444444444444444444444444444444444444444444444444444
444444444444444444444444444444444444444444444444444444444444444444444444444
444411000000000000000000000011444444444444400000000000000000114444444444444
44441100000P000000000000000000000000000000000000000000000000114444444444444
444411000000000000010000000000000000000000000011111000000000114444444444444
444444444444444000044444444444444444444444444444444000000000444444444444444
444444444444444000044444444444444444444444444444444000000000444444444444444
444444444444444400004444444444444444444444444444444400000000044444444444444
444444444444444400004444444444444444444444444444444000000000444444444444444
444444444444444400004444444444444444444444444444444000000000444444444444444
444444444444444400004444444444444444444444444444444000000000444444444444444
444444444444444400004444444444444444444444444444444000000000444444444444444
444444444444444400004444444444444444444444444444444000000000444444444444444
444444444444444400004444444444444444444444444444444000000000444444444444444
444444444444444400004444444444444444444444444444444000000000444444444444444
444444444444444400004444444444444444444444444444444000000000444444444444444
44444444444444440A004444444444444444444444444444444000000000444444444444444
444444444444444400004444444444444444444444444444444000000000444444444444444
444444444444444400004444444444444444444444444444444000000000444444444444444
444444444444444400004444444444444444444444444444444000000000444444444444444
44444444444444440000444444444444444444444444444444400000A000444444444444444
444444444444444400004444444444444444444444444444444000000000444444444444444
444444444444444400004444444444444444444444444444444000000000444444444444444
444444444444444400004444444444444444444444444444444000000000444444444444444
444444444444444400004444444444444444444444444444444000000000444444444444444
444444444444444400004444444444444444444444444444444000000000444444444444444
444444444444444400004444444444444444444444444444444000000000444444444444444
444444444444444400004444444444444444444444444444444000000000444444444444444
444444444444444400000000000000000000000000000044444400000000044444444444444
444444444444444400000000000000000000000000000044444400000000044444444444444
444444444444444400000000000000000000000000000044444400000000044444444444444
444444444444444400000000000000000000000000000044444400000000044444444444444
4444444444444444000000000000000B0000000000000044444400000000044444444444444
444444444444444400000000000000000000000000000044444400000000044444444444444
444444444444444400000000000000000000000000000044444400000000044444444444444
444444444444444400000000000000000000000000000044444400000000044444444444444
444444444444444444444444444444444444444444444444444444444444444444444444444
444444444444444444444444444444444444444444444444444444444444444444444444444
444444444444444444444444444444444444444444444444444444444444444444444444444
444444444444444444444444444444444444444444444444444444444444444444444444444