4444444444444444444444444444444444444444444
4444444444444444444444444444444444444444444
4444444444444444444444444444444444444444444
4444000000000000000000000000000000000004444
4444000000000000000000000000000000000004444
4444000000000000000000000000000000000004444
4444000000000000000000000000000000000004444
4444000000000000000000000000000000000004444
4444000000000000000000000000000000000004444
4444000000000000000000000000000000000004444
4444000000100000000000000000001000000004444
4444000000100000000000000000001000000004444
4444000000100000000000000000001000000004444
4444000000000000000000000000000000000004444
4444000000000000000P00000000000000000004444
4444000000000000000000000000000000000004444
4444000000000000000000000000000000000004444
4444444444444444444444444444444444444444444
4444444444444444444444444444444444444444444
4444444444444444444444444444444444444444444
